mere	HI
liye	HI
atm	AMB-HI
stands	EN
for	EN
any	EN
time	EN
maar	HI

sharma	HI
ji	HI
ka	AMB-HI
ladka	HI
made	EN
bhuvi	HI
sacrifice	EN
his	EN
wicket	HI

ab	HI
aa	AMB-HI
rahi	HI
hai	HI
naa	HI
king	AMB-EN
of	EN
the	EN
world	AMB-EN
waali	OTHER
feeling	EN

i	EN
think	EN
hum	HI
sarrhay	OTHER
char	AMB-EN
so	EN
runzain	OTHER
banain	OTHER
ge	AMB-EN
aaj	HI

u	AMB-EN
shudnt	OTHER
try	EN
on	EN
ur	AMB-EN
sisters	EN
friend	EN
courtesy	EN
naam	HI
ki	HI
bhi	HI
koi	HI
cheez	HI
hoti	HI
hai	HI
p	EN

yaar	HI
diploma	AMB-EN
course	EN
krne	OTHER
ka	AMB-HI
man	AMB-EN
h	EN
since	EN
mcom	EN
is	AMB-EN
over	EN

am	EN
i	EN
the	EN
only	EN
one	EN
jo	HI
abh	AMB-EN
tak	HI
yahii	EN
soch	HI
raha	AMB-HI
ha	AMB-EN
k	AMB-EN
f	EN
sc	AMB-EN
k	AMB-EN
bad	AMB-HI
kia	AMB-EN
karna	HI
haa	HI

flipkart	HI
walo	OTHER
mera	AMB-EN
phone	AMB-EN
deliver	EN
kar	HI
do	AMB-EN
fir	AMB-HI
jabong	HI
take	EN
over	EN
karo	HI

commercial	EN
market	AMB-EN
rawalpindi	HI
ki	HI
samosa	AMB-HI
chat	AMB-EN
hi	HI
koi	HI
parcel	AMB-EN
ker	AMB-EN
de	AMB-HI

haddiyon	HI
ke	HI
doctor	AMB-HI
bade	HI
ortho	EN
docs	EN
hote	HI
hain	HI

all	EN
day	EN
all	EN
night	EN
mujhe	HI
yaad	HI
sataye	OTHER
teri	HI

next	EN
year	EN
onwards	EN
ipl	HI
main	HI
match	AMB-HI
ni	AMB-HI
honge	HI
toss	AMB-HI
se	HI
hi	HI
decide	EN
kar	HI
lenge	HI

perfect	EN
relations	EN
walon	AMB-HI
se	HI
kehna	AMB-HI
jara	EN
volunteers	EN
se	HI
bhi	HI
relations	EN
sudharwayen	OTHER

if	EN
you	EN
really	EN
want	EN
to	AMB-EN
be	EN
happy	AMB-EN
in	EN
your	EN
life	EN
then	EN
bhool	HI
jao	EN
use	AMB-EN
jo	HI
tumhe	HI
bhul	HI
gya	AMB-HI

karachi	AMB-HI
men	EN
koo	EN
acha	HI
jga	EN
bataen	OTHER
jahan	AMB-HI
achi	AMB-EN
class	AMB-EN
ki	HI
celebrations	EN
hom	EN
aj	AMB-EN

1	OTHER
ghantay	OTHER
baad	HI
pakistani	HI
team	AMB-HI
push	EN
ups	EN
laga	HI
ke	HI
army	AMB-EN
trainers	EN
ko	HI
salute	EN
karay	HI
gi	EN

agar	HI
one	EN
word	EN
reply	EN
karke	HI
bhi	HI
interesting	EN
conversation	EN
chahte	HI
ho	HI
toh	AMB-HI
chutiye	OTHER
ho	HI
tum	HI

ok	EN
good	EN
night	EN
dher	HI
sare	AMB-EN
moments	EN
ginwa	OTHER
diye	HI
aaj	HI

is	AMB-EN
it	EN
only	EN
me	AMB-EN
ya	AMB-EN
waqayi	OTHER
karachi	AMB-HI
mein	AMB-HI
thand	HI
hogayi	HI
hai	HI

facebook	AMB-HI
inbox	EN
ke	HI
other	EN
messages	EN
main	HI
itna	HI
sara	AMB-HI
pyar	AMB-EN
para	AMB-EN
hai	HI

