Mere	HI
liye	HI
ATM	OTHER
stands	EN
for	EN
any	EN
time	EN
maar	HI
.	OTHER

Sharma	OTHER
ji	HI
ka	HI
ladka	HI
made	EN
bhuvi	OTHER
sacrifice	EN
his	EN
wicket	EN

ab	HI
aa	HI
rahi	HI
hai	HI
naa	HI
king	EN
of	EN
the	EN
world	EN
waali	HI
feeling	EN
?	OTHER

I	EN
think	EN
hum	HI
sarrhay	HI
char	HI
so	HI
runzain	OTHER
banain	HI
ge	HI
aaj	HI
.	OTHER

"	OTHER
U	EN
shudnt	EN
try	EN
on	EN
ur	EN
sisters	EN
friend	EN
Courtesy	EN
naam	HI
ki	HI
bhi	HI
koi	HI
cheez	HI
hoti	HI
hai	HI
..	OTHER
:p	OTHER
"	OTHER

Yaar	HI
diploma	EN
course	EN
krne	HI
ka	HI
man	HI
h	HI
since	EN
Mcom	OTHER
is	EN
over	EN
.	OTHER

Am	EN
I	EN
the	EN
only	EN
one	EN
jo	HI
abh	HI
tak	HI
yahii	HI
soch	HI
raha	HI
ha	HI
k	HI
F.	OTHER
Sc	OTHER
k	HI
bad	HI
kia	HI
karna	HI
haa	HI

Flipkart	OTHER
walo	HI
mera	HI
phone	EN
deliver	EN
kar	HI
do	HI
fir	HI
jabong	OTHER
take	EN
over	EN
Karo	HI
..	OTHER

Commercial	EN
market	EN
Rawalpindi	OTHER
ki	HI
samosa	OTHER
chat	HI
hi	HI
koi	HI
parcel	EN
ker	HI
de	HI
...	OTHER

haddiyon	HI
ke	HI
doctor	EN
,	OTHER
bade	HI
ortho	EN
docs	EN
hote	HI
hain	HI
!	OTHER

All	EN
day	EN
all	EN
night	EN
,	OTHER
mujhe	HI
yaad	HI
sataye	HI
teri	HI
:)	OTHER

Next	EN
year	EN
onwards	EN
IPL	OTHER
main	HI
match	EN
ni	HI
honge	HI
,	OTHER
toss	EN
se	HI
hi	HI
decide	EN
kar	HI
lenge	HI

Perfect	EN
Relations	EN
walon	HI
se	HI
kehna	HI
jara	HI
volunteers	EN
se	HI
bhi	HI
relations	EN
sudharwayen	HI
..	OTHER

"	OTHER
If	EN
you	EN
really	EN
Want	EN
to	EN
be	EN
Happy	EN
in	EN
your	EN
Life	EN
..	OTHER
Then	EN
bhool	HI
jao	HI
use	HI
jo	HI
tumhe	HI
bhul	HI
gya	HI
"	OTHER

Karachi	OTHER
men	HI
koo	HI
acha	HI
jga	HI
bataen	HI
jahan	HI
achi	HI
class	EN
ki	HI
celebrations	EN
hom	HI
aj	HI
?	OTHER

1	OTHER
ghantay	HI
baad	HI
Pakistani	OTHER
team	EN
Push	EN
ups	EN
laga	HI
ke	HI
Army	EN
trainers	EN
ko	HI
salute	EN
karay	HI
gi	HI
.	OTHER

Agar	HI
one	EN
word	EN
reply	EN
karke	HI
bhi	HI
interesting	EN
conversation	EN
chahte	HI
ho	HI
,	OTHER
toh	HI
chutiye	HI
ho	HI
tum	HI
.	OTHER

Ok	EN
good	EN
night	EN
dher	HI
sare	HI
moments	EN
ginwa	HI
diye	HI
aaj	HI

Is	EN
it	EN
only	EN
me	EN
ya	HI
waqayi	HI
Karachi	OTHER
mein	HI
thand	HI
hogayi	HI
hai	HI
?	OTHER

Facebook	OTHER
inbox	EN
ke	HI
other	EN
messages	EN
main	HI
itna	HI
sara	HI
pyar	HI
para	HI
hai	HI
.	OTHER
